19,126,74,91,52,92,37.3
19,189,78,115,111,64,36.8
19,110,62,78,48,88,36.7
19,110,60,77,50,68,36.7
19,120,85,97,35,85,36.6
19,100,70,80,30,104,36.9
19,130,70,90,60,120,36
19,105,50,68,55,64,36.8
19,128,91,103,37,74,36.7
19,130,70,90,60,64,37.7
19,120,80,93,40,80,36.7
19,142,109,120,33,114,36.8
19,133,74,94,59,60,36.4
19,124,82,96,42,87,37
